11111111111111111111111111111111111111111111111111
10000000000000000000000000000000000000000000000001
10111111111111111111111111111111111111111111111101
10100000000000000000000000000000000000000000000001
10101111110000000000000011111111111100000000000001
10000000000000000000000000000000000000000000000001
10000000000000000000000000000000000000000000000001
10000000000000000000000000000000000000000000000001
10000000000000000000000000000000000000000000000001
10000000000000000000000000000000000000000000000001
11111000000000000000000001111111100000000000000001
10001100000000000000000001000000000000000000000001
10000110000000000000000001000011111111111111000001
10000000000000000000000001000000000000000000000001
10000110000000000000000001000011111111111111000001
10001100000000000000000001000000000000000000000001
11111000000000001101100001111111100000000000000001
10000000000000001101100000000000000000000000000001
10000000000000000000000000000000000000000000000001
10000000000000001101100000000000000000000000000001
10000000000000001101100000000000000000000000000001
10000000000000000000000000000000000000000000000001
10000000000000000000000000000111111111111111110001
10000000000000000000000000000111100000000011110001
10000000000000000000000000000111111110111111110001
10000000000000000000000000000000000000000000000001
10000000000000000000000000000000000000000000000001
10111111111110000000000000000000000000000000000001
10000000000010000000111111111111100000000000000001
11111111110010000000100000000000100000000000000001
10000000000010000000000000000000000000000000000001
10111111111110000000100000000000100000000000000001
10000000000000000000111111111111100000000000000001
10000000000000000000000000000000000000000000000001
10000000000000000000000000000000000000000000000001
10000000000000000000000000000000000000000000000001
10000000000000000000000000000000000000000000000001
11111111111000000000000000000000000000000000000001
10000000011000000000000000000011111111111110000001
10000000000000000000000000000011111111111110000001
10000000011000000000000000000011111111111110000001
11111111111000000000000000000011111111111110000001
10000000000000000000000000000000000000000000000001
10000000000000000000000000000000000000000000000001
10000000000000000000000000000000000000000000000001
11111110000000000000000000000000011111111111111101
10000000000000000000000000000000010000000000000001
10000111111111000000000000000000010111111111111111
11000000000001000000000000000000010000000000000000
11111111111111111111111111111111111111111111111111